-xm = Extra Wide
Blk = Black
Wht = White
Stlgry = Stingray
Stngray = Stingray
Pnkcheetah = Pink Cheetah
Rsgld = Rose Gold
Brwnsgr = Brown Sugar
Black-M = Black
Black-Xw = Black
Bk Pny Rltl Tiedy = Black Pony Rltl Tiedy
Bk = Black
White-M = White
Mellwrose= Mellow Rose
Sldsndl = Slide Sandle
Yllw = Yellow
Sndl = Sandle
Pny Rltl = Pony Rltl 
Stlgry Jtblk Rdor = Stingray Jetblack 
Begoniapnk = Begonia Pink
Clsc Gtslx = Classic GTSL X
Clsc = Classic
Clscgt Xengnrgrmnts = Classic GT X Engineered Garments
Courtxprs = Court Express
Expreslightpcklbal2E = Express Light Pickleball 2E
Expreslightpicklebal = Express Light Pickleball
Exprslight3 = Express Light 3 
Hypercourtexpres2Hb = Hypercourt Express 2 HB
Cour66Xelevnbyvenusw = Court 66 X Eleven By Venus Williams
Expreslghtpcklblwide = Express Light Pickleball Wide
Hypercourtexprs2Wide = Hypercourt Express 2 Wide
Heavenlypink = Heavenly Pink
Anglbl Shrllc Brtwh = Angle Blue Sheer Lilac Brilliant White
Hyprcourtexpres2Xlil = Hypercourt Express 2 Lucky In Love
Sprklngmermd = Sparkling Mermaid
Clasclxxrandy'Sdonut = Classic XX Randys Donut
Clasiclxxbricks&Wood = Classic LX Bricks & Wood
Glowupflyawayjacket = Glow Up Flyaway Jacket
Hyprcourtsupremexlil = Hypercourt Supreme Lucky In Love
Pleatofthemoments = Pleat Of The Moment S/S
Rowingblzrsxkswshort = Rowing Blazers X
Si-18Ultrshtxmclaren = SI- 18 Ultrashot X Mclaren